{
  "team": "TeaMu",
  "mazeName": "maze5.json",
  "path": [
    "R4C50",
    "R3C50",
    "R2C50",
    "R2C49",
    "R2C48",
    "R2C47",
    "R2C46",
    "R2C45",
    "R2C44",
    "R2C43",
    "R2C42",
    "R2C41",
    "R2C40",
    "R2C39",
    "R2C38",
    "R2C37",
    "R2C36",
    "R2C35",
    "R2C34",
    "R2C33",
    "R2C32",
    "R2C31",
    "R2C30",
    "R2C29",
    "R2C28",
    "R2C27",
    "R2C26",
    "R2C25",
    "R2C24",
    "R2C23",
    "R2C22",
    "R2C21",
    "R2C20",
    "R2C19",
    "R2C18",
    "R2C17",
    "R2C16",
    "R2C15",
    "R2C14",
    "R2C13",
    "R2C12",
    "R2C11",
    "R2C10",
    "R2C9",
    "R2C8",
    "R2C7",
    "R2C6",
    "R2C5",
    "R2C4",
    "R2C3",
    "R2C2",
    "R3C2",
    "R4C2",
    "R5C2",
    "R6C2",
    "R7C2",
    "R8C2",
    "R9C2",
    "R10C2",
    "R11C2",
    "R12C2",
    "R13C2",
    "R14C2",
    "R15C2",
    "R16C2",
    "R17C2",
    "R18C2",
    "R19C2",
    "R20C2",
    "R21C2",
    "R22C2",
    "R23C2",
    "R24C2",
    "R25C2",
    "R26C2",
    "R27C2",
    "R28C2",
    "R29C2",
    "R30C2",
    "R31C2",
    "R32C2",
    "R33C2",
    "R34C2",
    "R35C2",
    "R36C2",
    "R37C2",
    "R38C2",
    "R39C2",
    "R40C2",
    "R41C2",
    "R42C2",
    "R43C2",
    "R44C2",
    "R45C2",
    "R46C2",
    "R47C2",
    "R48C2",
    "R49C2",
    "R50C2"
  ],
  "executionTime": 0.0
}