{
  "team": "TeaMu",
  "mazeName": "maze9.json",
  "path": [
    "R2C87",
    "R2C86",
    "R2C85",
    "R2C84",
    "R2C83",
    "R2C82",
    "R2C81",
    "R2C80",
    "R2C79",
    "R2C78",
    "R2C77",
    "R2C76",
    "R2C75",
    "R2C74",
    "R2C73",
    "R2C72",
    "R2C71",
    "R2C70",
    "R2C69",
    "R2C68",
    "R2C67",
    "R2C66",
    "R2C65",
    "R2C64",
    "R2C63",
    "R2C62",
    "R2C61",
    "R2C60",
    "R2C59",
    "R2C58",
    "R3C58",
    "R4C58",
    "R5C58",
    "R6C58",
    "R7C58",
    "R8C58",
    "R9C58",
    "R10C58",
    "R11C58",
    "R12C58",
    "R13C58",
    "R14C58",
    "R14C57",
    "R14C56",
    "R14C55",
    "R14C54",
    "R14C53",
    "R14C52",
    "R14C51",
    "R14C50",
    "R13C50",
    "R12C50",
    "R11C50",
    "R10C50",
    "R10C49",
    "R10C48",
    "R11C48",
    "R12C48",
    "R13C48",
    "R14C48",
    "R14C47",
    "R14C46",
    "R15C46",
    "R16C46",
    "R17C46",
    "R18C46",
    "R19C46",
    "R20C46",
    "R21C46",
    "R22C46",
    "R23C46",
    "R24C46",
    "R25C46",
    "R26C46",
    "R26C45",
    "R26C44",
    "R26C43",
    "R26C42",
    "R26C41",
    "R26C40",
    "R26C39",
    "R26C38",
    "R26C37",
    "R26C36",
    "R26C35",
    "R26C34",
    "R27C34",
    "R28C34",
    "R28C35",
    "R28C36",
    "R29C36",
    "R30C36",
    "R31C36",
    "R32C36",
    "R33C36",
    "R34C36",
    "R35C36",
    "R36C36",
    "R37C36",
    "R38C36",
    "R39C36",
    "R40C36",
    "R41C36",
    "R42C36",
    "R43C36",
    "R44C36",
    "R45C36",
    "R46C36",
    "R46C37",
    "R46C38",
    "R46C39",
    "R46C40",
    "R47C40",
    "R48C40",
    "R49C40",
    "R50C40",
    "R51C40",
    "R52C40",
    "R53C40",
    "R53C41",
    "R54C41",
    "R54C42",
    "R54C43",
    "R55C43",
    "R56C43",
    "R57C43",
    "R58C43",
    "R58C42",
    "R59C42",
    "R60C42",
    "R61C42",
    "R61C43",
    "R61C44",
    "R62C44",
    "R63C44",
    "R64C44",
    "R65C44",
    "R66C44",
    "R67C44",
    "R68C44",
    "R68C45",
    "R68C46",
    "R69C46",
    "R70C46",
    "R70C47",
    "R71C47",
    "R72C47",
    "R73C47",
    "R74C47",
    "R74C46",
    "R75C46",
    "R76C46",
    "R76C45",
    "R76C44",
    "R76C43",
    "R76C42",
    "R75C42",
    "R74C42",
    "R74C41",
    "R74C40",
    "R73C40",
    "R72C40",
    "R72C39",
    "R72C38",
    "R71C38",
    "R71C37",
    "R70C37",
    "R70C36",
    "R70C35",
    "R70C34",
    "R70C33",
    "R70C32",
    "R71C32",
    "R72C32",
    "R73C32",
    "R74C32",
    "R74C31",
    "R74C30",
    "R74C29",
    "R74C28",
    "R73C28",
    "R72C28",
    "R71C28",
    "R70C28",
    "R70C27",
    "R69C27",
    "R68C27",
    "R68C26",
    "R68C25",
    "R68C24",
    "R67C24",
    "R67C23",
    "R66C23",
    "R66C22",
    "R66C21",
    "R66C20",
    "R66C19",
    "R66C18",
    "R65C18",
    "R64C18",
    "R64C17",
    "R64C16",
    "R64C15",
    "R64C14",
    "R64C13",
    "R64C12",
    "R63C12",
    "R62C12",
    "R61C12",
    "R61C11",
    "R60C11",
    "R60C10",
    "R59C10",
    "R59C9",
    "R59C8",
    "R60C8",
    "R61C8",
    "R62C8",
    "R63C8",
    "R64C8",
    "R64C7",
    "R64C6",
    "R63C6",
    "R62C6",
    "R62C5",
    "R62C4",
    "R63C4",
    "R64C4",
    "R65C4",
    "R66C4",
    "R66C3",
    "R66C2",
    "R67C2",
    "R68C2",
    "R69C2",
    "R70C2",
    "R71C2",
    "R72C2",
    "R73C2",
    "R74C2",
    "R74C3",
    "R74C4",
    "R75C4",
    "R76C4",
    "R77C4",
    "R78C4",
    "R79C4",
    "R79C3",
    "R79C2",
    "R80C2",
    "R81C2",
    "R82C2",
    "R83C2",
    "R84C2",
    "R85C2",
    "R86C2",
    "R87C2",
    "R88C2",
    "R89C2",
    "R90C2"
  ],
  "executionTime": 0.01
}