{
  "team": "TeaMu",
  "mazeName": "maze4.json",
  "path": [
    "R7C6",
    "R6C6",
    "R6C5",
    "R6C4",
    "R5C4",
    "R4C4",
    "R3C4",
    "R2C4",
    "R2C5",
    "R2C6",
    "R2C7",
    "R2C8",
    "R2C9",
    "R2C10",
    "R2C11",
    "R3C11",
    "R4C11",
    "R5C11",
    "R6C11",
    "R6C12",
    "R6C13",
    "R6C14",
    "R7C14",
    "R8C14",
    "R9C14",
    "R9C15",
    "R9C16",
    "R10C16",
    "R10C17",
    "R10C18",
    "R10C19",
    "R10C20",
    "R11C20",
    "R12C20",
    "R13C20",
    "R14C20",
    "R15C20",
    "R16C20",
    "R16C21",
    "R16C22",
    "R16C23",
    "R16C24",
    "R17C24",
    "R18C24",
    "R19C24",
    "R20C24",
    "R20C25",
    "R20C26",
    "R20C27",
    "R21C27",
    "R21C28",
    "R22C28",
    "R23C28",
    "R24C28",
    "R24C29",
    "R24C30",
    "R24C31",
    "R24C32",
    "R25C32",
    "R26C32",
    "R27C32",
    "R28C32",
    "R29C32",
    "R30C32",
    "R31C32",
    "R32C32",
    "R33C32",
    "R34C32",
    "R35C32",
    "R36C32",
    "R37C32",
    "R38C32",
    "R38C33",
    "R38C34",
    "R38C35",
    "R38C36",
    "R39C36",
    "R40C36",
    "R40C37",
    "R40C38",
    "R40C39",
    "R40C40"
  ],
  "executionTime": 0.0
}