{
  "team": "TeaMu",
  "mazeName": "maze8.json",
  "path": [
    "R5C2",
    "R6C2",
    "R7C2",
    "R8C2",
    "R9C2",
    "R10C2",
    "R11C2",
    "R12C2",
    "R13C2",
    "R14C2",
    "R15C2",
    "R16C2",
    "R17C2",
    "R18C2",
    "R19C2",
    "R20C2",
    "R21C2",
    "R22C2",
    "R23C2",
    "R24C2",
    "R25C2",
    "R26C2",
    "R26C3",
    "R26C4",
    "R26C5",
    "R26C6",
    "R27C6",
    "R28C6",
    "R28C7",
    "R28C8",
    "R28C9",
    "R28C10",
    "R28C11",
    "R28C12",
    "R28C13",
    "R28C14",
    "R29C14",
    "R30C14",
    "R30C15",
    "R30C16",
    "R30C17",
    "R30C18",
    "R31C18",
    "R32C18",
    "R32C19",
    "R33C19",
    "R33C20",
    "R34C20",
    "R34C21",
    "R34C22",
    "R34C23",
    "R34C24",
    "R33C24",
    "R32C24",
    "R31C24",
    "R30C24",
    "R30C25",
    "R30C26",
    "R31C26",
    "R32C26",
    "R33C26",
    "R34C26",
    "R34C27",
    "R34C28",
    "R34C29",
    "R34C30",
    "R34C31",
    "R35C31",
    "R36C31",
    "R36C32",
    "R36C33",
    "R36C34",
    "R36C35",
    "R36C36",
    "R36C37",
    "R36C38",
    "R37C38",
    "R38C38",
    "R39C38",
    "R40C38",
    "R40C39",
    "R40C40",
    "R40C41",
    "R40C42",
    "R40C43",
    "R40C44",
    "R40C45",
    "R41C45",
    "R41C46",
    "R42C46",
    "R42C47",
    "R43C47",
    "R44C47",
    "R45C47",
    "R45C46",
    "R46C46",
    "R47C46",
    "R48C46",
    "R48C47",
    "R48C48",
    "R49C48",
    "R50C48",
    "R51C48",
    "R52C48",
    "R52C49",
    "R52C50",
    "R53C50",
    "R54C50",
    "R55C50",
    "R56C50",
    "R57C50",
    "R58C50",
    "R58C51",
    "R58C52",
    "R59C52",
    "R60C52",
    "R61C52",
    "R62C52",
    "R63C52",
    "R64C52",
    "R65C52",
    "R66C52",
    "R67C52",
    "R68C52",
    "R68C53",
    "R68C54",
    "R68C55",
    "R68C56",
    "R68C57",
    "R68C58",
    "R67C58",
    "R66C58",
    "R66C59",
    "R66C60",
    "R66C61",
    "R66C62",
    "R67C62",
    "R68C62",
    "R69C62",
    "R70C62",
    "R70C63",
    "R70C64",
    "R71C64",
    "R72C64",
    "R73C64",
    "R74C64",
    "R74C65",
    "R74C66",
    "R75C66",
    "R76C66",
    "R76C67",
    "R76C68",
    "R76C69",
    "R76C70",
    "R76C71",
    "R76C72",
    "R76C73",
    "R76C74",
    "R76C75",
    "R76C76",
    "R77C76",
    "R78C76",
    "R78C77",
    "R78C78",
    "R78C79",
    "R78C80",
    "R79C80",
    "R80C80"
  ],
  "executionTime": 0.0
}