{
  "team": "TeaMu",
  "mazeName": "maze3.json",
  "path": [
    "R22C29",
    "R22C30",
    "R21C30",
    "R20C30",
    "R20C29",
    "R19C29",
    "R18C29",
    "R18C28",
    "R18C27",
    "R18C26",
    "R18C25",
    "R18C24",
    "R19C24",
    "R20C24",
    "R21C24",
    "R22C24",
    "R22C23",
    "R23C23",
    "R23C22",
    "R24C22",
    "R25C22",
    "R26C22",
    "R27C22",
    "R28C22",
    "R28C21",
    "R28C20",
    "R28C19",
    "R28C18",
    "R29C18",
    "R29C17",
    "R29C16",
    "R30C16",
    "R30C15",
    "R30C14"
  ],
  "executionTime": 0.0
}