{
  "team": "TeaMu",
  "mazeName": "maze7.json",
  "path": [
    "R4C6",
    "R3C6",
    "R2C6",
    "R2C7",
    "R2C8",
    "R2C9",
    "R2C10",
    "R2C11",
    "R2C12",
    "R2C13",
    "R2C14",
    "R3C14",
    "R4C14",
    "R5C14",
    "R6C14",
    "R6C15",
    "R6C16",
    "R6C17",
    "R6C18",
    "R7C18",
    "R8C18",
    "R8C19",
    "R8C20",
    "R9C20",
    "R10C20",
    "R10C21",
    "R10C22",
    "R10C23",
    "R10C24",
    "R11C24",
    "R12C24",
    "R12C25",
    "R12C26",
    "R13C26",
    "R14C26",
    "R14C27",
    "R14C28",
    "R15C28",
    "R16C28",
    "R16C29",
    "R17C29",
    "R18C29",
    "R18C30",
    "R18C31",
    "R18C32",
    "R18C33",
    "R18C34",
    "R19C34",
    "R20C34",
    "R20C35",
    "R21C35",
    "R22C35",
    "R22C36",
    "R23C36",
    "R24C36",
    "R25C36",
    "R25C37",
    "R25C38",
    "R26C38",
    "R27C38",
    "R28C38",
    "R28C39",
    "R29C39",
    "R29C40",
    "R30C40",
    "R30C41",
    "R30C42",
    "R31C42",
    "R31C43",
    "R31C44",
    "R32C44",
    "R33C44",
    "R34C44",
    "R34C45",
    "R34C46",
    "R35C46",
    "R35C47",
    "R35C48",
    "R36C48",
    "R36C49",
    "R36C50",
    "R36C51",
    "R36C52",
    "R37C52",
    "R38C52",
    "R38C53",
    "R38C54",
    "R39C54",
    "R40C54",
    "R41C54",
    "R42C54",
    "R43C54",
    "R44C54",
    "R45C54",
    "R46C54",
    "R46C53",
    "R46C52",
    "R47C52",
    "R48C52",
    "R49C52",
    "R50C52",
    "R51C52",
    "R52C52",
    "R53C52",
    "R54C52",
    "R55C52",
    "R56C52",
    "R56C53",
    "R56C54",
    "R57C54",
    "R58C54",
    "R58C55",
    "R58C56",
    "R58C57",
    "R58C58",
    "R59C58",
    "R60C58",
    "R60C59",
    "R61C59",
    "R61C60",
    "R62C60",
    "R63C60",
    "R64C60",
    "R64C61",
    "R64C62",
    "R65C62",
    "R66C62",
    "R67C62",
    "R68C62",
    "R68C63",
    "R68C64",
    "R68C65",
    "R68C66",
    "R68C67",
    "R68C68",
    "R69C68",
    "R70C68",
    "R70C69",
    "R70C70"
  ],
  "executionTime": 0.0
}